####################
#P                 #
#                  #
#                  #
#        ######    #
#        #         #
#        # M       #
#        #         #
#                 G#
####################